R 640 480
NO ./path_to_the_north_texture
SO ./path_to_the_south_texture
WE ./path_to_the_west_texture
EA ./path_to_the_east_texture
S ./path_to_the_sprite_texture
F 220,100,0
C 225,30,0

11111111111111111111111111111111
10000000000000001000000000000001
10000000000000000000000000000001
11000000000000000000000000000011
1100000000000000S000020000000011
11000000000000000000000000000011
10000000000000000000000000000011
10000000000000000000000000000001
10000000000000011000000000000001
11111111111111111111111111111111
